NO ./maps/textures/eagle.xpm
SO ./maps/textures/eagle.xpm
WE ./maps/textures/eagle.xpm
EA ./maps/textures/eagle.xpm

F 70,70,70
C 0,  111, 204

11111111
10000001
1000W001
10000001
10000001
10000011
10000011
11111111