NO ./maps/textures/eagle.xpm
SO ./maps/textures/red.xpm
WE ./maps/textures/purplestone.xpm
EA ./maps/textures/greystone.xpm

F 70,70,70
C 0,  111, 204

11111111
1W000001
10000001
10000001
10000001
10000001
10000001
11111111