NO ./textures/wood.xpm
SO ./textures/greystone.xpm
WE ./textures/planks.xpm
EA ./textures/redbrick.xpm

F 70,70,70
C 0, 255, 204

   111111111111 111111111110
   1000000000110000000000001
    110000011100000000000011
   1001000000000000000000001
11110110 0000110000000000001
1000011 00000110111110111111
1111011111111011100000010001
1111011111111101110100010001
1100000011010101110000010001
1000000000000001100000010001
1000000000000000110100010001
11000001110101111011110N0111
11110111 1110101 11111010001
11111111 1111111 11111111111
