NO	textures/GrayWalls.xpm
SO	textures/GrayWalls.xpm
WE	textures/GrayWalls.xpm
EA	textures/GrayWalls.xpm
S	textures/barrel.xpm

R	5999 599999999999999999999999999999999999999
F	68, 68,  68
C	51, 204, 255

     01111111111111111110
    111011000001 00000011000001
       1  00000N000000
     1100000000000010
     110000000000000111
11111111000000001111111
1111111111111111111111111
111111111111111111011111
1111111111    11111111111111