NO	textures/GrayWalls.xpm
SO	textures/GrayWalls.xpm
WE	textures/GrayWalls.xpm
EA	textures/GrayWalls.xpm
S	textures/barrel.xpm

R	5999 599999999999999999999999999999999999999
F	68, 68,  68
C	51, 204, 255

1111111111111111111111
100000000000000212001
1000000000000000110001
10000000000N0000111110001
1000000000000000000000001
 11200000000000000000000001
1000000000000000000000001
1111111111111111111111111