NO	textures/GrayWalls.xpm
SO	textures/GrayWalls.xpm
WE	textures/GrayWalls.xpm
EA	textures/GrayWalls.xpm
S	textures/barrel.xpm

R	5999 599999999999999999999999999999999999999
F	68, 68,  68
C	51, 204, 255

11111111111111111   11111
10000000000000021   12001
10000000000000001   10001
1000000000000000111110001
1000000000000000000000001
1200000000000000000000001
1000000000000000000000001
1111111111111111111111111